School of Accounting and Finance|Darren Charters|dcharters@uwaterloo.ca
Anthropology|Gotz Hoeppe|ghoeppe@uwaterloo.ca
Applied Language Studies|Julia Williams|jpwillia@uwaterloo.ca
Arts and Business co-op & regular|Susan Andrews|sandrews@uwaterloo.ca
Church Music and Worship|Mark Vuorinen|mvuorinen@uwaterloo.ca
Classical Studies|Andrew Faulkner|afaulkne@uwaterloo.ca
Cognitive Science|Paul Thagard|pthagard@uwaterloo.ca
Computing and Financial Management|Jordyn Gray-McInnis|jagraymc@uwaterloo.ca
Drama|Robert Danisch|rdanisch@uwaterloo.ca	
Digital Arts Communication|Ceylan Turkeri|cturkeri@uwaterloo.ca
East Asian Studies|Damaris McKinley|damaris.mckinley@uwaterloo.ca
Economics|Lutz-Alexander Busch|lbusch@uwaterloo.ca
Economics|John Burbidge|jburbidge@uwaterloo.ca
Economics|Dinghai Xu (China 2+2 students)|dhxu@uwaterloo.ca
English|Jay Dolmage|englug@uwaterloo.ca
Environment and Economics minor|Alain Nimubona|animubon@uwaterloo.ca
Fine Arts|Cora Cluett|ccluett@uwaterloo.ca
French Studies|Tara Collington|tcollington@uwaterloo.ca
German|Paul Malone|pmalone@uwaterloo.ca	
Global Business and Digital Arts|Andrea West|amwest@uwaterloo.ca
History|Julia Roberts|robertsj@uwaterloo.ca
Human Resources Management|Theresa Bauer|tbauer@uwaterloo.ca
Human Sciences|Kieran Bonner|kieran.bonner@uwaterloo.ca
Independent Studies|Linda Carson|lccarson@uwaterloo.ca
International Studies|Veronica Kitchen|vkitchen@uwaterloo.ca
Islam Studies|Idrisa Pandit|idrisa.pandit@uwaterloo.ca
Italian Studies|Gabriel Niccoli|gniccoli@uwaterloo.ca
Jewish Studies|Jim Diamond|jdiamond@uwaterloo.ca
Legal Studies|Marina Topalcevic|mtopalce@uwaterloo.ca
Management Studies|Geoff Malleck|gmalleck@uwaterloo.ca
Medieval Studies|David Porreca|dporreca@uwaterloo.ca
Mennonite Studies|Marlene Epp|mgepp@uwaterloo.ca
Music|Mark Vuorinen|mvuorinen@uwaterloo.ca
Peace and Conflict Studies|Rachel Reist|rreist@uwaterloo.ca
Philosophy|Mathieu Doucet|mathieu.doucet@uwaterloo.ca
Political Science|Veronica Kitchen|vkitchen@uwaterloo.ca
Psychology - Major|Emily Mininger|emininger@uwaterloo.ca
Psychology - Minor|Theresa Bauer|tbauer@uwaterloo.ca
Religious Studies|Jim Diamond|jdiamond@uwaterloo.ca
Russian and East European Studies|Paul Malone|pmalone@uwaterloo.ca
Sexuality, Marriage, and Family Studies|John Arnou|jarnou@uwaterloo.ca
Sociology - Regular|Janice Aurini|jaurini@uwaterloo.ca
Sociology - Co-op|Sarah Wilkins-Laflamme|sarah.wilkins-laflamme@uwaterloo.ca
Spanish and Latin American Studies|Maria del Carmen Sillato|msillato@uwaterloo.ca
Speech Communication|Robert Danisch|rdanisch@uwaterloo.ca
Women's Studies|Shannon Dea|sjdea@uwaterloo.ca